{
	"blank": [
		"....................",
		"....................",
		"....................",
		"....................",
		"....................",
		"....................",
		"....................",
		"....................",
		"....................",
		"....................",
		"....................",
		"....................",
		"....................",
		"....................",
		"....................",
		"....................",
		"....................",
		"....................",
		"....................",
		"...................."
	],
	"map": [
		"MMMMMMMMMMMMMHMMMHMH",
		"MMCM..H..H....HMH...",
		"MMMRR..........H....",
		"MMM..R.RRRR...RR....",
		"HM....R....RRR.SR...",
		"MH..........H.D.R...",
		"H............DH.R...",
		"............D...R...",
		"...........D....R...",
		"....H.....D....R....",
		"...HH.....D...R.....",
		"....H.....D...R.....",
		"..........D..R....HH",
		"..........D..R.....H",
		"..........D...R.....",
		"...H......D...R.....",
		".HHM......D..R......",
		"HHMODDDDDDD.R....H..",
		".HHM......DR......HH",
		"...H......DR.....HHM"
	],
	"explored": [
		".***................",
		".*************......",
		".****************...",
		".....************...",
		"......*....******...",
		"............*****...",
		"....................",
		"....................",
		"....................",
		"....................",
		"....................",
		"....................",
		"....................",
		"....................",
		"....................",
		"....................",
		"....................",
		"....................",
		"....................",
		"...................."
	],
	"route": [
		"....................",
		"..ABCDEFGHI.........",
		"...........J........",
		"............K.......",
		".............LMN....",
		"....................",
		"....................",
		"....................",
		"....................",
		"....................",
		"....................",
		"....................",
		"....................",
		"....................",
		"....................",
		"....................",
		"....................",
		"....................",
		"....................",
		"...................."
	],
	"resources": [
		"....................",
		"....0...............",
		"....................",
		"....................",
		"....................",
		"....................",
		"....................",
		"....................",
		"....................",
		"....................",
		"....................",
		"....................",
		"....................",
		"....................",
		"....................",
		"....................",
		"....................",
		"....................",
		"....................",
		"...................."
	]
}
