{
	"blank": [
		"....................",
		"....................",
		"....................",
		"....................",
		"....................",
		"....................",
		"....................",
		"....................",
		"....................",
		"....................",
		"....................",
		"....................",
		"....................",
		"....................",
		"....................",
		"....................",
		"....................",
		"....................",
		"....................",
		"...................."
	],
	"map": [
		"MMMMMMMMMMMMMHMMMHMH",
		"MMCM..H..H....HMH...",
		"MMMRR.HH.H.....H....",
		"MMM..R.RRRR...RR....",
		"HM....R....RRR.SR...",
		"MH..........H.D.R...",
		"H............DH.R...",
		"............D...R...",
		"...........D....R...",
		"....H.....D....R....",
		"...HH.....D...R.....",
		"....H.....D...R.....",
		"..........D..R....HH",
		".H........D..R.....H",
		"..........D...R.....",
		"...H......D...R.....",
		".HHM......D..R......",
		"HHMODDDDDDD.R....H..",
		".HHM......DR......HH",
		"...H......DR.....HHM"
	],
	"test": [
		"********************",
		"********************",
		"********************",
		"********************",
		"*******.************",
		"********************",
		"********************",
		"********************",
		"********************",
		"********************",
		"********************",
		"********************",
		"********************",
		"********************",
		"********************",
		"********************",
		"********************",
		"********************",
		"********************",
		"********************"
	],
	"explored": [
		".***................",
		".*************......",
		".****************...",
		".....************...",
		"......*....******...",
		"............*****...",
		"....................",
		"....................",
		"....................",
		"....................",
		"....................",
		"....................",
		"....................",
		"....................",
		"....................",
		"....................",
		"....................",
		"....................",
		"....................",
		"...................."
	],
	"route": [
		"....................",
		"..ABCDEFGHIJ........",
		"............K.......",
		".............L......",
		"..............MN....",
		"....................",
		"....................",
		"....................",
		"....................",
		"....................",
		"....................",
		"....................",
		"....................",
		"....................",
		"....................",
		"....................",
		"....................",
		"....................",
		"....................",
		"...................."
	],
	"resources": [
		"....................",
		"....0...............",
		"....................",
		"...1................",
		"....................",
		"....................",
		"2...................",
		"....................",
		"....................",
		"....................",
		".....3..............",
		"....................",
		"...................5",
		"....................",
		"....................",
		"....................",
		"....................",
		"...4................",
		".................6..",
		"...................."
	]
}
